10 9
###....##.
..........
.########.
.#........
.###.*#.#.
o..####.#.
.#.#....#.
.#.#.##.#.
........#.
