10 8
.#........
.#.######.
.#....#...
.###.*#.#.
...####.#.
.#.#..#.#.
.#.#.##.#.
o#......#.
