12 8
###.......##
###.####.#.#
#.#....#...#
..###.*#.#.#
.o..####.###
#.#.#..#.###
#.#.#.##...#
..#......#.#



